5
S . . . .
. . . . .
. # # # .
. . # . .
. . F . .