10
S . . . . . . . . .
. . # . . . . . . .
. # # # # # # # . #
. . # . . . . . . .
. . # . . # . . # #
. . # . . # . . # #
. . # . . # # # # #
. . # . . . . . . .
. . # # # # . . # #
. . # # # # . . . F