5
S . . . .
. . # . .
. # # # .
. . # . .
. . . . F